tschdisk = mmchdisk
tscheckquota = mmcheckquota
tschmgr = mmchmgr
tschqos = mmchqos
tscrsnapshot = mmcrsnapshot
tsdefragfs = mmdefragfs
tsdelsnapshot = mmdelsnapshot
tsdf = mmdf
tsreclaimspace = mmreclaimspace
tsedquota = mmedquota
tsfsck = mmfsck
tsfsckx = mmfsckx
tslsfsckx = mmlsfsckx
tsfsctl = mmfsctl
tslsdisk = mmlsdisk
tslsfs = mmlsfs
tslsmgr = mmlsmgr
tslspool = mmlspool
tslsqos = mmlsqos
tscachectl = mmcachectl
tslsquota = mmlsquota
tslssnapshot = mmlssnapshot
tspmon = mmpmon
tsrepquota = mmrepquota
tsressnapshot = mmrestorefs
tsrestripefs = mmrestripefs
tssetquota = mmsetquota
tssnapdir = mmsnapdir
# tssnaplatest = mmsnaplatest
tschfileset = mmchfileset
tslsfileset = mmlsfileset
tslspolicy = mmlspolicy
mmrcmd = mmrcp
mmrcmd = mmrsh
mmumount = mmunmount
tschattr = mmchattr
tsclone = mmclone
tsdefedquota = mmdefedquota
tsdefquotaoff = mmdefquotaoff
tsdefquotaon = mmdefquotaon
tsdelacl = mmdelacl
tsdiag = mmdiag
tseditacl = mmeditacl
tsexpelnode = mmexpelnode
tsgetacl = mmgetacl
tsgskkm = mmgskkm
tskmipkm = mmkmipkm
tslsattr = mmlsattr
tsputacl = mmputacl
tsquotaoff = mmquotaoff
tsquotaon = mmquotaon
tsrestripefile = mmrestripefile
